#########################################
#.......#...#...#...#...........#.......#
#.#.###.#.###.#.#.#.#.#######.#.#.#####.#
#.#.#.....#...#.#.#.........#.#.#.#.....#
#.#.#######.###.###########.#.#.#.#.#####
#.#.#.....#.#.#...........#.#.#.#.#.#...#
#.#.#.###.#.#.###########.#.#.#.#.###.#.#
#.#...#...#.#...#...#.....#.#.#.#.#...#.#
#.#####.#.#.#.#.#.#.#.#####.#.#.#.#.###.#
#.#.....#.#.#.#...#...#...#.#.#...#...#.#
###.###.###.#.#########.#.#.#.#######.#.#
#...#...#...#...#...#.#.#.#.#.#.......#.#
#.###.###.#####.#.#.#.#.#.#.#.#.#######.#
#...#.#.#.#...#.#.#.#...#.#.#.#...#.#...#
###.#.#.#.#.###.#.#.###.#.#.#.###.#.#.###
#...#...#.#...#...#...#.#...#...#...#...#
#.#######.#.#.#######.#########.###.###.#
#.#.....#.#.#...#.............#...#.#...#
#.#.###.#.###.###.###########.#.#.#.#.###
#...#.#.#...#...#...#.#.....#.#.#...#...#
#.###.#.###.###.#.###.#.###.#.#.#######.#
#.#...#...#...#...#...#...#...#...#.#...#
#.###.#.#####.#####.#####.#######.#.#.###
#.#...#.....#.......#...#.....#.....#...#
#.#.#######.#########.#######.#######.#.#
#...#.......#.....#.......#...#.....#.#.#
#.###.###.###.###.#.###.#.#.###.###.#.#.#
#.#...#...#...#.#.....#.#.#.#...#...#.#.#
#.#.#.#####.###.#######.#.#.###.#.#####.#
#.#.#.#.....#.......#...#.#.#...#.#.....#
#.#.#.#.#####.#####.#.#####.#.###.###.#.#
#.#.#.#.....#...#...#...#...#...#.....#.#
#.#.#######.###.#######.#.###.#.#######.#
#.#.#.....#.....#.......#.#...#.#...#...#
#.#.#.###.###.###.#######.#####.###.#.###
#.#.....#.#...#...#.......#.....#...#...#
#.#######.#.###.#.#.#######.#####.#####.#
#.#.#.....#.#.#.#.#.....#...#...#.....#.#
#.#.#.#####.#.#.#######.#.###.#.#.#.###.#
#...#.........#...........#...#...#.....#
#########################################